40,40,37,35,35,35,35,37,37,35
40,40,37,37,37,37,37,37,37,35
40,40,37,35,35,35,35,37,37,35
40,40,37,37,37,37,37,37,37,35
40,40,37,35,35,35,35,37,37,35
37,37,37,37,37,37,37,37,37,35
37,35,35,35,35,35,35,37,37,35
0,35,35,35,35,35,35,0,0,0
[METADATA]
