78,73,0,52,53,53,54,0,0,66
0,67,0,0,0,0,0,0,0,65
0,0,0,52,53,53,54,0,0,64
0,69,0,0,0,0,0,0,0,63
81,76,0,58,57,57,56,0,0,66
0,0,0,0,0,0,0,0,0,65
0,0,0,0,0,0,0,0,0,64
0,39,40,39,40,39,40,0,0,0
[METADATA]
