0,0,0,0,0,0,0,0,0,0,0,0,0,0,0,0,0,0,0,0,0,0,0,0,0,0,0,0,0,93,0,0,0,0,87,78,78,78,78,78,78,78,78,78,78,95,0,0,0,0,0,0,0,0,0,0,0,0,0,0,0,0,0,0,0,0,0,0,0,0
0,0,0,0,0,0,0,0,0,0,0,0,0,0,0,0,0,0,0,0,0,0,0,0,0,0,0,0,0,72,95,0,0,87,80,0,0,0,0,0,0,0,0,0,0,72,95,0,0,0,0,0,0,0,0,0,0,0,0,0,0,0,0,0,0,0,0,0,0,0
0,0,0,0,0,0,0,0,0,0,0,0,0,87,78,78,78,78,78,78,78,78,95,0,0,0,0,0,0,0,72,95,0,101,0,0,0,0,0,0,0,0,0,0,0,0,72,78,78,95,0,0,0,0,0,0,0,0,0,0,0,0,0,0,0,0,0,0,0,0
0,0,87,78,78,78,78,78,78,78,78,78,78,80,0,0,0,0,0,0,0,0,72,78,78,78,78,78,95,0,0,72,95,88,77,79,0,0,0,0,0,0,0,0,0,0,0,0,0,72,78,78,95,0,0,0,0,0,0,0,0,0,0,0,0,0,0,0,0,0
0,87,80,0,0,87,78,78,78,78,78,78,78,78,78,78,78,78,78,95,0,0,0,0,0,0,0,0,72,95,0,0,93,0,0,101,0,0,0,0,0,0,0,0,0,0,0,0,0,0,0,0,72,78,78,78,78,78,78,95,0,0,0,0,0,0,0,0,0,0
0,101,0,0,87,80,0,0,0,0,0,0,0,0,0,0,0,0,0,0,0,0,0,0,0,0,0,0,0,72,95,0,93,0,0,101,0,0,0,0,0,87,78,78,78,78,78,78,0,78,95,0,0,0,0,0,0,0,0,72,95,0,0,0,0,0,0,0,0,0
87,80,0,0,101,0,0,0,0,0,0,0,0,0,0,0,0,0,0,72,78,78,78,78,78,78,0,78,95,0,93,0,93,0,87,80,0,0,0,0,87,80,0,0,0,0,0,0,0,0,72,71,77,0,77,77,79,0,0,0,72,95,0,0,0,0,0,0,0,0
80,0,0,87,80,0,0,0,0,0,0,0,0,0,0,0,0,0,71,77,77,77,77,79,0,0,0,0,93,0,93,0,72,78,80,0,0,0,0,0,101,0,0,0,0,0,0,0,0,0,71,96,0,0,0,0,88,79,0,0,0,72,95,0,0,0,0,0,0,0
0,0,87,80,0,0,0,0,0,0,0,0,0,0,0,0,71,77,96,0,0,0,0,101,0,0,0,0,93,0,93,0,0,0,0,0,0,0,0,0,101,0,0,0,0,0,0,0,0,71,96,0,0,0,0,0,0,88,79,0,0,0,72,78,95,0,0,0,0,0
0,87,80,0,0,0,0,0,0,0,0,0,71,77,77,77,96,0,71,79,0,0,87,80,0,0,0,0,93,0,93,0,0,0,0,0,0,0,0,0,101,0,0,0,0,0,0,0,0,93,0,0,0,0,0,0,0,0,88,77,79,0,0,0,72,78,78,95,0,0
87,80,0,0,0,0,0,0,0,0,71,77,96,0,0,0,0,71,96,101,0,0,101,0,0,0,0,0,93,0,93,0,0,87,78,78,78,78,78,78,80,0,0,0,0,0,0,0,0,93,0,0,0,71,0,0,79,0,0,0,88,77,79,0,0,0,0,72,78,78
101,0,0,0,0,0,0,0,0,71,96,0,71,77,77,77,77,96,87,80,0,0,101,0,0,0,0,0,72,78,93,0,87,80,0,0,0,0,0,0,0,0,0,0,0,0,0,0,71,96,0,0,0,93,0,0,88,79,0,0,0,0,88,77,79,0,0,0,0,0
101,0,0,0,0,0,0,0,71,96,0,0,93,0,0,0,0,0,101,0,0,87,80,0,0,0,0,0,0,0,93,0,101,0,0,0,0,0,0,0,0,0,0,0,0,0,0,0,93,0,0,71,77,96,0,0,0,101,0,0,0,0,0,0,88,79,78,78,0,78
101,0,0,0,0,0,0,0,93,0,71,77,96,0,0,0,0,0,101,0,0,101,0,0,0,0,0,0,0,0,93,0,101,0,0,0,0,0,0,0,0,0,0,0,0,0,0,71,96,0,0,93,0,0,0,0,0,88,79,0,0,0,0,0,0,101,0,0,0,0
101,0,0,0,0,0,0,0,93,0,93,0,0,0,0,0,0,87,80,0,0,101,0,0,0,0,0,0,0,0,93,0,88,79,0,0,0,0,0,0,0,0,0,0,0,0,0,93,0,0,71,96,0,71,77,0,77,79,88,77,77,79,0,0,0,101,0,0,0,0
101,0,0,0,0,0,0,0,93,71,96,0,0,0,0,0,0,101,0,0,0,101,0,0,0,0,0,0,0,0,93,0,0,101,0,71,77,77,77,77,79,0,0,0,0,0,0,93,0,0,93,0,0,93,0,0,0,101,0,0,0,101,0,0,0,101,0,0,0,0
88,79,0,0,0,0,0,71,93,93,0,0,0,0,0,0,0,101,0,0,0,101,0,0,0,0,0,0,0,0,93,0,0,101,0,93,0,0,0,0,101,0,0,0,0,0,0,93,0,0,93,0,0,93,0,0,0,101,0,0,0,101,0,0,0,101,0,0,0,0
79,101,0,0,0,0,0,93,93,93,0,0,0,0,0,0,0,101,0,0,0,101,0,0,0,0,0,0,0,0,93,0,0,101,0,93,0,0,0,0,101,0,0,0,0,0,0,93,0,0,93,0,0,93,0,0,87,80,0,0,0,101,0,0,0,101,0,0,0,0
101,101,0,0,0,0,0,93,93,93,0,0,0,0,0,0,0,101,0,0,0,101,0,0,0,0,0,0,0,0,93,0,0,88,77,96,0,0,0,0,101,0,0,0,0,0,0,93,0,0,93,0,0,72,78,78,80,0,0,0,87,80,0,0,0,101,0,0,0,0
101,101,0,0,0,0,0,93,93,93,0,0,0,0,0,0,0,101,0,0,0,101,0,0,0,0,0,0,0,0,93,0,0,0,0,0,0,0,0,0,101,0,0,0,0,0,0,93,0,0,93,0,0,0,0,0,0,0,87,78,80,0,0,0,0,101,0,0,0,0
80,101,0,0,0,0,0,93,93,93,0,0,0,0,0,0,0,101,0,0,0,101,0,0,0,0,0,0,0,0,72,95,0,0,0,0,0,0,0,87,80,0,0,0,0,0,0,93,0,0,72,95,0,0,0,0,0,87,80,0,0,0,0,0,0,101,0,0,0,0
87,80,0,0,0,0,0,93,93,72,95,0,0,0,0,0,0,101,0,0,0,88,79,0,0,0,0,0,0,0,0,72,78,95,0,0,0,0,87,80,0,0,0,0,0,0,0,93,0,0,0,72,78,78,78,78,78,80,0,0,0,0,0,87,78,80,0,0,0,0
101,0,0,0,0,0,0,72,93,0,93,0,0,0,0,0,0,102,0,0,0,0,101,0,0,0,0,0,0,0,0,0,0,72,78,78,78,78,80,0,0,0,0,0,0,0,0,93,0,0,0,0,0,0,0,0,0,87,78,78,78,78,78,80,0,0,0,0,0,0
101,0,0,0,0,0,0,0,93,0,72,95,0,0,0,0,0,0,0,0,0,0,88,79,0,0,0,0,0,0,0,0,0,0,0,0,0,0,0,0,0,0,0,0,0,0,0,93,0,0,0,0,0,87,78,78,78,80,0,0,0,0,0,0,0,0,0,0,0,71
101,0,0,0,0,0,0,0,93,0,0,93,0,0,0,0,0,0,0,0,0,0,0,101,0,0,0,0,0,0,0,0,0,0,0,0,0,0,0,0,0,0,0,0,0,0,0,93,0,87,78,78,78,80,0,0,0,0,0,0,0,0,0,0,0,0,0,0,71,96
101,0,0,0,0,0,0,0,93,0,0,93,0,0,0,0,0,0,0,0,0,0,0,88,79,0,0,0,0,0,0,0,0,0,0,0,0,0,0,0,0,0,0,0,0,0,71,96,87,80,0,0,0,0,0,0,0,0,0,0,0,0,0,0,0,0,0,71,96,0
101,0,0,0,0,0,0,0,93,0,0,93,0,0,69,77,77,79,0,0,0,0,0,0,101,0,0,0,0,0,0,0,0,0,0,0,0,0,0,0,0,0,0,0,0,71,96,0,101,0,0,0,0,0,0,0,0,0,0,0,0,0,0,0,0,71,77,96,0,0
101,0,0,0,0,0,0,71,96,71,77,96,0,0,0,0,0,88,79,0,0,0,0,0,101,0,71,77,77,77,77,77,77,77,77,77,77,77,77,77,77,79,0,0,71,96,0,87,80,0,71,77,77,77,77,77,77,77,79,0,0,0,71,77,77,96,0,0,0,0
88,79,0,0,0,0,71,96,71,96,0,0,0,71,77,77,77,79,88,77,79,0,0,0,88,77,96,0,71,77,77,77,77,77,77,77,77,79,0,0,0,88,77,77,77,77,77,77,77,77,96,0,0,0,0,0,0,0,88,79,0,71,96,0,0,0,0,0,0,0
0,101,0,0,0,71,96,71,96,0,71,77,77,96,0,0,0,88,79,0,88,77,77,77,79,0,71,77,96,0,0,0,0,0,0,0,0,88,77,77,77,79,0,0,0,0,0,0,0,0,0,0,0,0,0,0,0,0,0,88,77,96,0,0,0,0,0,0,0,0
[METADATA]
