0,0,0,0,0,0,148,148,148,148,148,148,148,0,0,148,148,148,148,148,148,148,148,148,148,148,148,148,0,0,148,148,148,148,173,181,0,0,0,0,0,0,0,0,0,0,0,181,181,181
180,180,180,180,180,180,180,180,180,180,180,188,148,148,0,0,0,148,148,148,148,148,148,148,148,0,0,0,0,148,148,148,148,172,192,181,181,181,181,181,181,181,181,181,181,181,181,0,0,0
0,0,0,0,0,0,181,181,0,0,0,184,180,180,188,148,0,0,148,148,148,148,148,148,0,0,132,172,180,180,180,180,180,192,181,181,181,181,0,0,0,0,0,0,0,0,0,0,181,181
181,181,181,181,181,181,181,181,181,181,0,0,0,0,184,180,188,0,0,0,0,0,0,0,0,172,180,192,181,0,0,0,84,84,84,212,0,0,0,181,181,181,181,181,181,181,181,181,181,181
0,0,0,0,0,0,0,181,181,181,181,181,181,0,0,0,184,180,180,180,180,188,132,132,172,192,0,0,0,0,181,0,84,532,84,212,181,181,181,181,181,181,181,181,181,181,0,0,0,0
181,181,181,181,181,181,0,0,0,0,0,0,0,0,0,0,0,0,0,0,0,184,180,180,192,0,0,181,181,181,181,0,84,84,2118,0,0,0,0,0,0,0,0,181,181,181,181,0,0,0
0,0,0,0,0,0,0,0,0,0,0,0,0,0,0,0,0,181,181,181,0,0,0,0,0,0,181,181,0,0,0,0,2120,2120,2128,181,0,0,0,0,0,0,0,0,0,0,0,0,181,181
181,181,181,181,181,181,181,181,181,181,181,181,181,0,0,0,0,0,0,0,0,181,181,181,0,0,0,0,0,0,0,0,0,181,181,181,181,181,181,181,181,181,181,181,181,181,181,181,181,181
181,181,181,181,181,181,181,181,181,181,181,181,181,181,0,0,0,0,0,0,0,0,0,0,0,0,0,0,0,0,181,181,181,181,181,181,181,181,181,181,181,181,181,181,181,181,181,181,181,181
182,182,182,182,182,182,182,182,191,181,181,181,181,181,181,181,181,181,181,0,0,0,0,0,0,0,181,181,181,181,181,181,181,181,181,181,181,181,181,181,181,181,181,181,181,181,181,181,181,181
132,132,132,132,132,132,132,132,174,191,181,181,181,181,181,181,181,181,181,181,181,181,181,181,181,181,181,181,181,181,181,181,181,181,181,181,181,181,181,181,181,181,181,181,181,181,181,181,181,181
180,180,180,180,180,180,180,180,188,174,191,181,181,181,181,181,181,181,181,181,181,181,181,181,181,181,181,181,181,181,181,181,181,181,181,181,181,181,181,181,181,181,181,181,181,181,181,181,181,181
181,181,181,181,181,181,181,181,184,188,174,182,191,181,181,181,181,181,181,181,181,181,181,181,181,181,181,181,181,181,181,181,181,181,181,181,181,181,181,183,182,182,182,182,182,182,182,182,182,182
181,181,181,181,181,181,181,181,181,184,188,132,174,191,181,181,181,181,181,181,181,181,181,181,181,181,183,182,182,182,182,182,182,182,182,182,182,182,182,190,132,132,132,132,132,132,132,132,132,132
181,181,181,181,181,181,181,181,181,181,184,188,132,174,191,181,181,181,181,181,181,181,181,181,183,182,190,132,132,132,132,132,132,132,132,132,132,132,132,132,132,172,180,180,180,180,180,180,180,180
181,181,181,181,181,181,181,181,181,181,181,184,180,188,174,182,191,181,181,181,181,181,183,182,190,132,172,180,180,180,180,180,180,180,180,180,180,180,180,180,180,192,181,181,181,181,181,181,181,181
181,181,181,181,181,181,181,181,181,181,181,181,181,184,180,188,174,182,191,181,181,183,190,172,180,180,192,181,181,181,181,181,181,181,181,181,181,181,181,181,181,181,181,181,181,181,181,181,181,181
181,181,181,181,181,181,181,181,181,181,181,181,181,181,181,184,180,188,174,182,182,190,172,192,181,181,181,181,181,181,181,181,181,181,181,181,181,181,181,181,181,181,181,181,181,181,181,181,181,181
0,0,0,0,0,0,181,181,181,181,181,181,181,181,181,181,181,184,188,132,132,172,192,181,181,181,181,181,181,181,181,181,181,181,181,181,181,181,181,181,181,181,181,181,181,181,181,181,181,181
181,181,181,181,181,0,181,181,181,181,181,181,181,181,181,181,181,181,189,132,172,192,181,181,181,181,181,181,181,181,181,181,181,181,181,181,181,181,181,181,181,181,181,181,181,181,181,181,181,181
181,181,181,181,181,0,0,0,181,181,181,181,181,181,181,181,181,181,189,132,173,181,181,181,181,181,181,181,181,181,181,181,181,181,181,181,181,181,181,181,181,181,181,181,181,181,181,181,181,181
181,181,181,181,181,181,181,0,0,181,181,181,181,181,181,181,181,181,189,132,173,181,181,181,181,181,181,181,181,181,181,181,181,181,181,181,181,181,181,181,181,181,181,181,181,181,181,181,181,181
181,181,181,181,181,181,181,181,0,181,181,181,181,181,181,181,181,181,189,132,173,181,181,181,181,181,181,181,181,181,181,181,181,181,181,181,181,181,181,181,181,181,181,181,181,181,181,181,181,181
181,181,181,181,181,181,181,181,0,0,0,181,181,181,181,181,181,181,189,132,173,181,181,181,181,181,181,181,181,181,181,181,181,0,0,0,0,0,0,0,181,181,181,181,181,181,181,181,181,181
181,181,181,181,181,181,181,181,181,181,0,0,0,181,181,181,181,181,189,132,173,181,181,181,181,181,181,181,181,181,181,181,0,0,0,0,0,0,0,0,0,0,0,181,181,181,181,181,181,181
181,183,182,182,182,191,181,181,181,181,181,0,0,181,181,181,181,181,189,132,173,181,181,181,181,181,181,181,181,181,181,181,0,0,0,0,0,0,0,0,0,0,0,0,181,181,181,181,181,181
183,190,132,132,132,174,182,181,181,181,181,0,0,181,181,181,181,181,189,132,174,191,181,181,181,181,181,181,181,181,181,181,0,0,0,0,0,0,0,0,0,0,0,0,0,181,181,181,181,181
190,172,180,180,188,172,180,181,181,181,181,181,0,181,181,181,181,181,189,132,132,174,182,182,182,182,182,182,182,182,182,191,0,0,0,0,0,0,0,0,0,0,0,0,0,0,181,181,181,181
172,192,181,181,189,173,181,181,181,181,181,181,0,181,181,181,181,181,189,132,132,132,172,180,180,180,180,180,180,180,180,192,0,0,46,0,0,0,0,0,0,0,0,0,0,0,0,181,181,181
192,181,181,181,189,173,181,181,181,181,181,0,0,181,181,181,181,181,189,132,132,172,192,181,181,181,181,181,181,181,181,181,0,0,0,0,0,0,0,0,0,0,0,0,0,0,0,181,181,181
181,181,181,181,189,173,181,181,0,0,0,0,181,181,181,181,181,181,189,132,172,192,181,181,181,181,181,181,181,181,181,181,0,0,0,0,0,0,0,0,0,0,0,0,0,0,0,181,181,181
181,181,181,181,189,173,181,0,0,181,181,181,181,181,181,181,181,181,189,132,173,181,181,181,181,181,181,181,181,181,181,181,0,0,0,0,0,0,0,0,0,0,0,0,0,0,0,181,181,181
181,181,0,0,202,202,0,0,181,181,181,181,181,181,181,181,181,181,189,132,173,181,181,181,181,181,181,181,181,181,181,181,181,181,181,0,0,0,0,0,0,0,0,0,0,0,181,181,181,181
0,0,0,181,181,181,181,181,181,181,181,181,181,181,181,181,181,181,189,132,173,181,181,181,181,181,181,181,181,181,181,181,181,181,181,181,181,181,181,181,0,0,0,0,0,0,181,181,181,181
181,181,181,181,181,181,181,181,181,181,181,181,181,181,181,181,181,181,189,132,173,181,181,181,181,181,181,181,181,181,181,181,181,181,181,181,181,181,181,181,181,181,181,181,181,181,181,181,181,181
181,181,181,181,181,181,181,181,181,181,181,181,181,181,181,181,181,181,189,132,173,181,181,181,181,181,181,181,181,181,181,181,181,181,181,181,181,181,181,181,181,181,181,181,181,181,181,181,181,181
181,181,181,181,181,181,181,181,181,181,181,181,181,181,181,181,181,181,189,132,173,181,181,181,181,181,181,181,181,181,181,181,181,181,181,181,181,181,181,181,181,181,181,181,181,181,181,181,181,181
181,181,181,181,181,181,181,181,181,181,181,181,181,181,181,181,181,181,184,180,192,181,181,181,181,181,181,181,181,181,181,181,181,181,181,181,181,181,181,181,181,181,181,181,181,181,181,181,181,181
182,182,182,182,182,182,182,182,182,191,181,181,181,181,181,181,181,181,181,181,181,181,181,181,181,181,181,181,181,181,181,181,181,181,181,181,181,181,181,181,181,181,181,181,181,181,181,181,181,181
140,140,140,140,140,140,140,140,140,174,182,182,191,181,181,181,181,181,181,181,181,181,181,181,181,181,181,181,181,181,181,181,181,181,181,181,181,181,181,181,181,181,181,181,181,181,181,181,181,181
140,140,140,140,140,140,140,140,140,140,140,140,174,182,191,181,181,181,181,181,181,181,181,181,181,181,181,183,182,182,182,182,182,182,182,182,182,182,191,181,181,181,181,181,181,181,181,181,181,181
140,140,140,140,140,140,140,140,140,140,140,140,140,140,174,182,191,181,181,181,181,181,181,181,181,183,182,190,140,140,140,140,140,140,140,140,140,140,174,182,182,191,181,181,181,181,181,181,181,181
140,140,140,140,140,140,140,140,140,140,140,140,140,140,140,140,173,181,181,181,181,181,183,182,182,190,140,140,140,140,140,140,140,140,140,140,140,140,140,140,140,174,182,182,191,181,181,181,181,181
140,140,140,140,140,140,140,140,140,140,140,140,140,140,140,140,173,181,181,181,181,181,189,140,140,140,140,140,140,140,140,140,140,140,140,140,140,140,140,140,140,140,140,140,174,191,181,181,181,181
140,140,140,140,140,140,140,140,140,140,140,140,140,140,140,140,173,181,181,181,181,181,189,140,140,140,140,140,140,140,140,140,140,140,140,140,140,140,140,140,140,140,140,140,140,174,182,191,181,181
140,140,140,140,140,140,140,140,140,140,140,140,140,140,140,140,173,181,181,181,181,181,189,140,140,140,140,140,140,140,140,140,140,140,140,140,140,140,140,140,140,140,140,140,140,140,140,174,191,181
2109,2109,2109,2109,2115,140,140,140,140,140,140,140,140,140,140,140,174,182,182,182,182,182,190,140,140,140,140,140,140,140,140,140,140,140,140,140,140,140,140,140,140,140,140,140,140,140,140,140,174,182
2108,2108,2108,2108,46,2109,2109,2115,140,46,46,46,46,140,140,140,140,140,140,140,140,140,140,140,140,140,140,140,140,140,140,140,140,140,140,140,140,140,140,140,140,140,140,140,140,140,140,140,140,140
140,140,140,140,2114,2108,2108,46,2109,46,46,46,2106,140,140,140,140,140,140,140,140,140,140,140,140,140,140,140,140,140,140,140,140,140,140,140,140,140,140,140,140,140,140,140,140,140,140,140,140,140
140,140,140,140,140,140,140,2114,2108,2108,2108,2108,46,2109,2109,2109,2109,2115,140,140,140,140,140,140,140,140,140,140,140,46,46,46,140,46,140,140,140,140,140,140,140,140,140,140,140,140,140,140,140,140
140,140,140,140,140,140,140,140,140,140,140,140,2114,2108,2108,2108,46,46,2115,140,140,140,140,140,140,140,140,140,2114,2108,2108,2108,46,2106,140,140,140,140,140,140,140,140,140,140,140,140,140,140,140,140
140,140,140,140,140,140,140,140,140,140,140,140,140,140,140,140,2114,46,46,2115,140,140,140,140,140,140,140,140,140,140,140,140,2111,2106,140,140,140,140,140,140,140,140,140,140,140,140,140,140,140,140
172,180,180,180,180,180,180,180,188,140,140,140,140,140,140,140,140,2114,46,46,2115,140,140,140,140,140,140,140,140,140,140,140,2111,2106,140,140,140,140,140,140,140,140,140,140,140,140,140,140,140,140
192,212,212,212,212,212,212,212,184,180,188,140,140,140,140,140,140,140,2114,46,46,2115,140,140,140,140,140,140,140,140,140,140,2111,2106,140,140,140,140,140,140,140,140,140,140,140,140,140,140,140,140
212,212,212,212,212,212,212,212,212,212,184,188,140,140,140,140,140,140,140,2111,46,2106,140,140,140,140,140,140,140,140,140,140,46,46,140,140,140,140,140,140,140,140,140,140,140,140,140,140,140,140
212,212,212,212,212,212,212,212,212,212,212,184,188,140,140,140,140,140,140,2111,46,2106,140,140,140,140,140,140,140,140,140,140,46,46,140,140,140,140,140,140,140,140,140,140,140,140,140,140,140,140
212,212,212,212,212,212,212,212,212,212,212,212,184,188,140,140,140,140,140,2111,46,2106,140,140,140,140,140,140,140,140,140,140,46,46,140,140,140,140,140,140,140,140,140,140,140,140,140,140,140,140
212,212,212,212,212,212,212,212,212,212,212,212,212,184,188,140,140,140,140,2111,46,2106,140,140,46,46,46,46,46,46,46,140,46,46,46,46,46,46,46,140,46,46,46,46,46,140,140,140,140,140
212,212,212,212,212,212,212,212,212,212,212,212,212,212,184,188,140,140,140,2111,46,46,2109,46,46,46,46,46,46,46,46,46,46,46,46,46,46,46,46,2109,46,46,46,46,46,2109,2109,2109,2109,2109
212,212,212,212,212,212,212,212,212,212,212,212,212,212,212,189,140,140,140,2111,46,46,46,46,46,46,46,46,46,46,46,46,46,46,46,46,46,46,46,46,46,46,46,46,46,46,46,46,46,46
212,212,212,212,212,212,212,212,212,212,212,212,212,212,212,189,140,140,140,2111,46,46,2108,46,46,46,46,46,46,46,46,46,46,46,46,46,46,46,46,2108,46,46,46,46,46,2108,2108,2108,2108,2108
212,212,212,212,212,212,212,212,212,212,212,212,212,212,183,140,140,140,140,2111,46,2106,140,140,140,140,140,140,140,140,140,140,46,46,140,140,140,140,140,140,140,140,140,140,140,140,140,140,140,140
212,212,212,212,212,212,212,212,212,212,212,212,212,183,190,140,140,140,140,2111,46,2106,140,140,140,140,140,140,140,140,140,140,46,46,140,140,140,140,140,140,140,140,140,140,140,140,140,140,140,140
212,212,212,212,212,212,212,212,212,212,212,183,182,190,140,140,140,140,140,2111,46,2106,140,140,140,140,140,140,140,140,140,140,46,46,140,140,140,140,140,140,140,140,140,140,140,140,140,140,140,140
191,212,212,212,212,212,212,212,183,182,182,190,140,140,140,140,140,140,140,2111,46,2106,140,140,140,140,140,140,140,140,140,140,2108,2108,140,140,140,140,140,140,140,140,140,140,140,140,140,140,140,140
174,191,212,212,212,212,183,182,190,140,140,140,140,140,140,140,140,140,140,2111,46,2106,140,140,140,140,140,140,140,140,140,140,140,140,140,140,140,140,140,140,140,140,140,140,140,140,140,140,140,140
140,174,182,182,182,182,190,140,140,140,140,140,140,140,140,140,140,140,140,2111,46,2106,140,140,140,140,140,140,140,140,140,140,140,140,140,140,140,140,140,140,140,140,140,140,140,140,140,140,140,140
140,140,140,140,140,140,140,140,140,140,140,140,140,140,2111,46,46,2106,140,2111,46,2106,140,140,140,140,140,140,140,140,140,140,140,140,140,140,140,140,140,140,140,140,140,140,140,140,140,140,140,140
140,140,140,140,140,140,140,140,140,140,140,2113,2109,2109,46,46,46,46,2109,46,46,46,2109,140,140,140,140,140,140,140,140,140,140,140,140,140,140,140,140,140,140,140,140,140,140,140,140,140,140,140
140,140,140,140,140,140,140,140,140,140,140,2114,2108,2108,2108,2108,2108,2108,2108,46,46,46,2108,140,140,140,140,140,140,140,140,140,140,140,140,140,140,140,140,140,140,140,140,140,140,140,140,140,140,140
140,140,140,140,140,140,140,140,140,140,140,140,140,140,140,140,140,140,140,2111,46,2106,140,140,140,140,140,140,140,140,140,140,140,140,140,140,140,140,140,140,140,140,140,140,140,140,140,140,140,140
140,140,140,140,140,140,140,140,140,140,140,140,140,140,140,140,140,140,140,2111,46,2106,140,140,140,140,140,140,140,140,140,140,140,140,140,140,140,140,140,140,140,140,140,140,140,140,140,140,140,140
140,140,140,140,140,140,140,140,140,140,140,140,140,140,140,140,140,140,140,2111,46,2106,140,140,140,140,140,140,140,140,140,140,140,140,140,140,140,140,140,140,140,140,140,140,140,140,140,140,140,140
140,140,140,140,140,140,140,140,140,140,140,140,140,140,140,140,140,140,140,2111,46,46,2109,140,140,140,140,140,140,140,140,140,140,140,140,140,140,140,140,140,140,140,140,140,140,140,140,140,140,140
140,140,140,140,140,140,140,140,140,140,140,140,140,140,140,140,140,140,140,2111,46,46,2108,140,140,140,140,140,140,140,140,140,140,140,140,140,140,140,140,140,140,140,140,140,140,140,140,140,140,140
[METADATA]
