181,181,181,181,181,181,148,148,148,148,148,148,148,148,148,148,148,148,148,148,148,148,148,148,148,148,148,148,148,148,148,148,148,148,173,181,181,181,181,181,181,181,181,181,181,181,181,181,181,181
180,180,180,180,180,180,180,180,180,180,180,188,148,148,148,148,148,148,148,148,148,148,148,148,148,148,148,148,148,148,148,148,148,172,192,181,181,181,181,181,181,181,181,181,181,181,181,181,181,181
181,181,181,181,181,181,181,181,181,181,181,184,180,180,188,148,148,148,148,148,148,148,148,148,148,148,132,172,180,180,180,180,180,192,181,181,181,181,181,181,181,181,181,181,181,181,181,181,181,181
181,181,181,181,181,181,181,181,181,181,181,181,181,181,184,180,188,148,148,148,148,148,148,148,148,172,180,192,181,181,181,181,181,181,181,181,181,181,181,181,181,181,181,181,181,181,181,181,181,181
181,181,181,181,181,181,181,181,181,181,181,181,181,181,181,181,184,180,180,180,180,188,132,132,172,192,181,181,181,181,181,181,181,181,181,181,181,181,181,181,181,181,181,181,181,181,181,181,181,181
181,181,181,181,181,181,181,181,181,181,181,181,181,181,181,181,181,181,181,181,181,184,180,180,192,181,181,181,181,181,181,181,181,181,181,181,181,181,181,181,181,181,181,181,181,181,181,181,181,181
181,181,181,181,181,181,181,181,181,181,181,181,181,181,181,181,181,181,181,181,181,181,181,181,181,181,181,181,181,181,181,181,181,181,181,181,181,181,181,181,181,181,181,181,181,181,181,181,181,181
181,181,181,181,181,181,181,181,181,181,181,181,181,181,181,181,181,181,181,181,181,181,181,181,181,181,181,181,181,181,181,181,181,181,181,181,181,181,181,181,181,181,181,181,181,181,181,181,181,181
181,181,181,181,181,181,181,181,181,181,181,181,181,181,181,181,181,181,181,181,181,181,181,181,181,181,181,181,181,181,181,181,181,181,181,181,181,181,181,181,181,181,181,181,181,181,181,181,181,181
182,182,182,182,182,182,182,182,191,181,181,181,181,181,181,181,181,181,181,181,181,181,181,181,181,181,181,181,181,181,181,181,181,181,181,181,181,181,181,181,181,181,181,181,181,181,181,181,181,181
132,132,132,132,132,132,132,132,174,191,181,181,181,181,181,181,181,181,181,181,181,181,181,181,181,181,181,181,181,181,181,181,181,181,181,181,181,181,181,181,181,181,181,181,181,181,181,181,181,181
180,180,180,180,180,180,180,180,188,174,191,181,181,181,181,181,181,181,181,181,181,181,181,181,181,181,181,181,181,181,181,181,181,181,181,181,181,181,181,181,181,181,181,181,181,181,181,181,181,181
181,181,181,181,181,181,181,181,184,188,174,182,191,181,181,181,181,181,181,181,181,181,181,181,181,181,181,181,181,181,181,181,181,181,181,181,181,181,181,183,182,182,182,182,182,182,182,182,182,182
181,181,181,181,181,181,181,181,181,184,188,132,174,191,181,181,181,181,181,181,181,181,181,181,181,181,183,182,182,182,182,182,182,182,182,182,182,182,182,190,132,132,132,132,132,132,132,132,132,132
181,181,181,181,181,181,181,181,181,181,184,188,132,174,191,181,181,181,181,181,181,181,181,181,183,182,190,132,132,132,132,132,132,132,132,132,132,132,132,132,132,172,180,180,180,180,180,180,180,180
181,181,181,181,181,181,181,181,181,181,181,184,180,188,174,182,191,181,181,181,181,181,183,182,190,132,172,180,180,180,180,180,180,180,180,180,180,180,180,180,180,192,181,181,181,181,181,181,181,181
181,181,181,181,181,181,181,181,181,181,181,181,181,184,180,188,174,182,191,181,181,183,190,172,180,180,192,181,181,181,181,181,181,181,181,181,181,181,181,181,181,181,181,181,181,181,181,181,181,181
181,181,181,181,181,181,181,181,181,181,181,181,181,181,181,184,180,188,174,182,182,190,172,192,181,181,181,181,181,181,181,181,181,181,181,181,181,181,181,181,181,181,181,181,181,181,181,181,181,181
181,181,181,181,181,181,181,181,181,181,181,181,181,181,181,181,181,184,188,132,132,172,192,181,181,181,181,181,181,181,181,181,181,181,181,181,181,181,181,181,181,181,181,181,181,181,181,181,181,181
181,181,181,181,181,181,181,181,181,181,181,181,181,181,181,181,181,181,184,188,172,192,181,181,181,181,181,181,181,181,181,181,181,181,181,181,181,181,181,181,181,181,181,181,181,181,181,181,181,181
181,181,181,181,181,181,181,181,181,181,181,181,181,181,181,181,181,181,181,189,173,181,181,181,181,181,181,181,181,181,181,181,181,181,181,181,181,181,181,181,181,181,181,181,181,181,181,181,181,181
181,181,181,181,181,181,181,181,181,181,181,181,181,181,181,181,181,181,181,189,173,181,181,181,181,181,181,181,181,181,181,181,181,181,181,181,181,181,181,181,181,181,181,181,181,181,181,181,181,181
181,181,181,181,181,181,181,181,181,181,181,181,181,181,181,181,181,181,181,189,173,181,181,181,181,181,181,181,181,181,181,181,181,181,181,181,181,181,181,181,181,181,181,181,181,181,181,181,181,181
181,181,181,181,181,181,181,181,181,181,181,181,181,181,181,181,181,181,181,189,173,181,181,181,181,181,181,181,181,181,181,181,181,181,181,181,181,181,181,181,181,181,181,181,181,181,181,181,181,181
181,181,181,181,181,181,181,181,181,181,181,181,181,181,181,181,181,181,181,189,173,181,181,181,181,181,181,181,181,181,181,181,181,181,181,181,181,181,181,181,181,181,181,181,181,181,181,181,181,181
181,183,182,182,182,191,181,181,181,181,181,181,181,181,181,181,181,181,181,189,173,181,181,181,181,181,181,181,181,181,181,181,181,181,181,181,181,181,181,181,181,181,181,181,181,181,181,181,181,181
183,190,132,132,132,174,182,181,181,181,181,181,181,181,181,181,181,181,181,189,174,191,181,181,181,181,181,181,181,181,181,181,181,181,181,181,181,181,181,181,181,181,181,181,181,181,181,181,181,181
190,172,180,180,188,172,180,181,181,181,181,181,181,181,181,181,181,181,181,189,132,174,182,182,182,182,182,182,182,182,182,191,181,181,181,181,181,181,181,181,181,181,181,181,181,181,181,181,181,181
172,192,181,181,189,173,181,181,181,181,181,181,181,181,181,181,181,181,181,189,132,132,172,180,180,180,180,180,180,180,180,192,181,181,181,181,181,181,181,181,181,181,181,181,181,181,181,181,181,181
192,181,181,181,189,173,181,181,181,181,181,181,181,181,181,181,181,181,181,189,132,172,192,181,181,181,181,181,181,181,181,181,181,181,181,181,181,181,181,181,181,181,181,181,181,181,181,181,181,181
181,181,181,181,189,173,181,181,181,181,181,181,181,181,181,181,181,181,181,189,172,192,181,181,181,181,181,181,181,181,181,181,181,181,181,181,181,181,181,181,181,181,181,181,181,181,181,181,181,181
181,181,181,181,189,173,181,181,181,181,181,181,181,181,181,181,181,181,181,189,173,181,181,181,181,181,181,181,181,181,181,181,181,181,181,181,181,181,181,181,181,181,181,181,181,181,181,181,181,181
181,181,181,181,202,202,181,181,181,181,181,181,181,181,181,181,181,181,181,189,173,181,181,181,181,181,181,181,181,181,181,181,181,181,181,181,181,181,181,181,181,181,181,181,181,181,181,181,181,181
181,181,181,181,181,181,181,181,181,181,181,181,181,181,181,181,181,181,181,189,173,181,181,181,181,181,181,181,181,181,181,181,181,181,181,181,181,181,181,181,181,181,181,181,181,181,181,181,181,181
181,181,181,181,181,181,181,181,181,181,181,181,181,181,181,181,181,181,181,189,173,181,181,181,181,181,181,181,181,181,181,181,181,181,181,181,181,181,181,181,181,181,181,181,181,181,181,181,181,181
181,181,181,181,181,181,181,181,181,181,181,181,181,181,181,181,181,181,181,189,173,181,181,181,181,181,181,181,181,181,181,181,181,181,181,181,181,181,181,181,181,181,181,181,181,181,181,181,181,181
181,181,181,181,181,181,181,181,181,181,181,181,181,181,181,181,181,181,181,189,173,181,181,181,181,181,181,181,181,181,181,181,181,181,181,181,181,181,181,181,181,181,181,181,181,181,181,181,181,181
181,181,181,181,181,181,181,181,181,181,181,181,181,181,181,181,181,181,181,184,192,181,181,181,181,181,181,181,181,181,181,181,181,181,181,181,181,181,181,181,181,181,181,181,181,181,181,181,181,181
182,182,182,182,182,182,182,182,182,191,181,181,181,181,181,181,181,181,181,181,181,181,181,181,181,181,181,181,181,181,181,181,181,181,181,181,181,181,181,181,181,181,181,181,181,181,181,181,181,181
140,140,140,140,140,140,140,140,140,174,182,182,191,181,181,181,181,181,181,181,181,181,181,181,181,181,181,181,181,181,181,181,181,181,181,181,181,181,181,181,181,181,181,181,181,181,181,181,181,181
140,140,140,140,140,140,140,140,140,140,140,140,174,182,191,181,181,181,181,181,181,181,181,181,181,181,181,183,182,182,182,182,182,182,182,182,182,182,191,181,181,181,181,181,181,181,181,181,181,181
140,140,140,140,140,140,140,140,140,140,140,140,140,140,174,182,182,191,181,181,181,181,181,181,181,183,182,190,140,140,140,140,140,140,140,140,140,140,174,182,182,191,181,181,181,181,181,181,181,181
140,140,140,140,140,140,140,140,140,140,140,140,140,140,140,140,140,173,181,181,181,181,183,182,182,190,140,140,140,140,140,140,140,140,140,140,140,140,140,140,140,174,182,182,191,181,181,181,181,181
140,140,140,140,140,140,140,140,140,140,140,140,140,140,140,140,140,173,181,181,181,181,189,140,140,140,140,140,140,140,140,140,140,140,140,140,140,140,140,140,140,140,140,140,174,191,181,181,181,181
140,140,140,140,140,140,140,140,140,140,140,140,140,140,140,140,140,173,181,181,181,181,189,140,140,140,140,140,140,140,140,140,140,140,140,140,140,140,140,140,140,140,140,140,140,174,182,191,181,181
140,140,140,140,140,140,140,140,140,140,140,140,140,140,140,140,140,173,181,181,181,181,189,140,140,140,140,140,140,140,140,140,140,140,140,140,140,140,140,140,140,140,140,140,140,140,140,174,191,181
46,46,46,46,46,140,140,140,140,140,140,140,140,140,140,140,140,174,182,182,182,182,190,140,140,140,140,140,140,140,140,140,140,140,140,140,140,140,140,140,140,140,140,140,140,140,140,140,174,182
46,46,46,46,46,46,46,46,140,140,140,140,140,140,140,140,140,140,140,140,140,140,140,140,140,140,140,140,140,140,140,140,140,140,140,140,140,140,140,140,140,140,140,140,140,140,140,140,140,140
140,140,140,140,46,46,46,46,46,46,46,46,46,140,140,140,140,140,140,140,140,140,140,140,140,140,140,140,140,140,140,140,140,140,140,140,140,140,140,140,140,140,140,140,140,140,140,140,140,140
140,140,140,140,140,140,140,46,46,46,46,46,46,46,46,46,46,46,140,140,140,140,140,140,140,140,140,140,140,140,140,140,140,140,140,140,140,140,140,140,140,140,140,140,140,140,140,140,140,140
140,140,140,140,140,140,140,140,140,140,140,140,46,46,46,46,46,46,46,140,140,140,140,140,140,140,140,140,140,140,140,140,140,140,140,140,140,140,140,140,140,140,140,140,140,140,140,140,140,140
140,140,140,140,140,140,140,140,140,140,140,140,140,140,140,140,46,46,46,46,140,140,140,140,140,140,140,140,140,140,140,140,140,140,140,140,140,140,140,140,140,140,140,140,140,140,140,140,140,140
140,140,140,140,140,140,140,140,140,140,140,140,140,140,140,140,140,46,46,46,46,140,140,140,140,140,140,140,140,140,140,140,140,140,140,140,140,140,140,140,140,140,140,140,140,140,140,140,140,140
140,212,212,212,212,212,212,212,140,140,140,140,140,140,140,140,140,140,46,46,46,46,140,140,140,140,140,140,140,140,140,140,140,140,140,140,140,140,140,140,140,140,140,140,140,140,140,140,140,140
212,212,212,212,212,212,212,212,212,212,140,140,140,140,140,140,140,140,140,46,46,46,140,140,140,140,140,140,140,140,140,140,140,140,140,140,140,140,140,140,140,140,140,140,140,140,140,140,140,140
212,212,212,212,212,212,212,212,212,212,212,140,140,140,140,140,140,140,140,46,46,46,140,140,140,140,140,140,140,140,140,140,140,140,140,140,140,140,140,140,140,140,140,140,140,140,140,140,140,140
212,212,212,212,212,212,212,212,212,212,212,212,140,140,140,140,140,140,140,46,46,46,140,140,140,140,140,140,140,140,140,140,140,140,140,140,140,140,140,140,140,140,140,140,140,140,140,140,140,140
212,212,212,212,212,212,212,212,212,212,212,212,212,140,140,140,140,140,140,46,46,46,140,140,46,46,46,46,46,46,46,140,140,140,46,46,46,46,140,140,140,140,140,140,140,140,140,140,140,140
212,212,212,212,212,212,212,212,212,212,212,212,212,212,140,140,140,140,140,46,46,46,46,46,46,46,46,46,46,46,46,46,46,46,46,46,46,46,46,46,46,46,46,46,46,46,46,46,46,46
212,212,212,212,212,212,212,212,212,212,212,212,212,212,212,140,140,140,140,46,46,46,46,46,46,46,46,46,46,46,46,46,46,46,46,46,46,46,46,46,46,46,46,46,46,46,46,46,46,46
212,212,212,212,212,212,212,212,212,212,212,212,212,212,212,140,140,140,140,46,46,46,46,46,46,46,46,46,46,46,46,46,46,46,46,46,46,46,46,46,46,46,46,46,46,46,46,46,46,46
212,212,212,212,212,212,212,212,212,212,212,212,212,212,140,140,140,140,140,46,46,46,140,140,140,140,140,140,140,140,140,140,140,140,140,140,140,140,140,140,140,140,140,140,140,140,140,140,140,140
212,212,212,212,212,212,212,212,212,212,212,212,212,140,140,140,140,140,140,46,46,46,140,140,140,140,140,140,140,140,140,140,140,140,140,140,140,140,140,140,140,140,140,140,140,140,140,140,140,140
212,212,212,212,212,212,212,212,212,212,212,140,140,140,140,140,140,140,140,46,46,46,140,140,140,140,140,140,140,140,140,140,140,140,140,140,140,140,140,140,140,140,140,140,140,140,140,140,140,140
140,212,212,212,212,212,212,212,140,140,140,140,140,140,140,140,140,140,140,46,46,46,140,140,140,140,140,140,140,140,140,140,140,140,140,140,140,140,140,140,140,140,140,140,140,140,140,140,140,140
140,140,212,212,212,212,140,140,140,140,140,140,140,140,140,140,140,140,140,46,46,46,140,140,140,140,140,140,140,140,140,140,140,140,140,140,140,140,140,140,140,140,140,140,140,140,140,140,140,140
140,140,140,140,140,140,140,140,140,140,140,140,140,140,140,140,140,140,140,46,46,46,140,140,140,140,140,140,140,140,140,140,140,140,140,140,140,140,140,140,140,140,140,140,140,140,140,140,140,140
140,140,140,140,140,140,140,140,140,140,140,140,140,140,46,46,46,46,140,46,46,46,140,140,140,140,140,140,140,140,140,140,140,140,140,140,140,140,140,140,140,140,140,140,140,140,140,140,140,140
140,140,140,140,140,140,140,140,140,140,140,140,46,46,46,46,46,46,46,46,46,46,140,140,140,140,140,140,140,140,140,140,140,140,140,140,140,140,140,140,140,140,140,140,140,140,140,140,140,140
140,140,140,140,140,140,140,140,140,140,140,140,46,46,46,46,46,46,46,46,46,46,140,140,140,140,140,140,140,140,140,140,140,140,140,140,140,140,140,140,140,140,140,140,140,140,140,140,140,140
140,140,140,140,140,140,140,140,140,140,140,140,140,140,140,140,140,140,140,46,46,46,140,140,140,140,140,140,140,140,140,140,140,140,140,140,140,140,140,140,140,140,140,140,140,140,140,140,140,140
140,140,140,140,140,140,140,140,140,140,140,140,140,140,140,140,140,140,140,46,46,46,140,140,140,140,140,140,140,140,140,140,140,140,140,140,140,140,140,140,140,140,140,140,140,140,140,140,140,140
140,140,140,140,140,140,140,140,140,140,140,140,140,140,140,140,140,140,140,46,46,46,140,140,140,140,140,140,140,140,140,140,140,140,140,140,140,140,140,140,140,140,140,140,140,140,140,140,140,140
140,140,140,140,140,140,140,140,140,140,140,140,140,140,140,140,140,140,140,46,46,46,140,140,140,140,140,140,140,140,140,140,140,140,140,140,140,140,140,140,140,140,140,140,140,140,140,140,140,140
140,140,140,140,140,140,140,140,140,140,140,140,140,140,140,140,140,140,140,46,46,46,140,140,140,140,140,140,140,140,140,140,140,140,140,140,140,140,140,140,140,140,140,140,140,140,140,140,140,140
[METADATA]
