0,0,0,0,0,0,0,0,0,0,0,0,0,0,0,0,0,0,0,0,0,0,0,0,0,0,0,0,0,0,0,0,0,0,0,0,0,0,0,0,0,0,0,0,0,0,0,0,0,0
0,0,0,0,0,0,0,0,0,0,0,0,0,0,0,0,0,0,0,0,0,0,0,0,0,0,0,0,0,0,0,0,0,0,0,0,0,0,0,0,0,0,110,113,0,0,0,0,0,0
0,0,0,0,0,0,0,110,113,0,0,0,0,0,0,0,0,0,0,0,0,0,0,0,0,0,0,0,0,0,0,0,0,0,0,0,0,0,0,110,113,0,111,114,0,0,0,0,0,0
0,110,113,0,0,0,0,111,114,0,0,0,0,0,0,0,0,0,0,0,0,0,0,0,0,0,0,0,110,113,0,0,0,0,0,0,0,0,0,111,114,0,112,115,0,0,0,0,0,0
0,111,114,0,0,0,0,112,115,0,0,0,0,0,0,0,0,110,113,0,0,0,0,0,0,0,110,113,111,114,0,0,0,0,0,0,0,0,0,112,115,0,0,0,0,0,0,0,0,0
0,112,115,0,0,0,0,0,0,0,0,0,0,0,0,0,0,111,114,0,0,110,113,0,0,0,111,114,112,115,0,0,0,0,0,0,0,0,0,0,0,0,0,0,0,0,0,0,0,0
0,110,113,0,0,110,113,0,0,0,0,0,0,0,0,0,0,112,115,0,0,111,114,0,0,0,112,115,0,0,0,0,0,0,0,0,110,113,0,0,0,0,0,110,113,0,0,0,110,113
0,111,114,0,182,111,114,0,0,0,110,113,0,0,0,0,0,0,0,0,0,112,115,0,0,0,0,0,0,0,0,0,0,0,0,0,111,114,0,0,0,110,113,111,114,0,110,113,111,114
0,112,115,0,0,112,115,0,0,0,111,114,0,0,0,0,0,0,0,0,0,0,0,0,0,0,110,113,0,0,0,110,113,0,0,0,112,115,182,110,113,111,114,112,115,0,111,114,112,115
0,0,0,0,0,0,0,0,0,0,112,115,0,0,110,113,0,0,0,110,113,0,0,110,113,0,111,114,0,0,0,111,114,0,0,0,110,113,0,111,114,112,115,110,113,0,112,115,110,113
0,0,0,0,0,0,0,0,0,0,0,0,0,0,111,114,182,0,0,111,114,0,0,111,114,0,112,115,110,113,0,112,115,0,0,0,111,114,0,112,115,0,0,111,114,0,0,0,111,114
0,0,0,0,0,0,0,0,0,0,0,0,0,0,112,115,110,113,0,112,115,0,182,112,115,0,0,0,111,114,0,182,0,0,0,0,112,115,0,0,0,0,0,112,115,0,0,0,112,115
0,110,113,0,110,113,0,0,0,0,0,0,0,0,0,0,111,114,0,0,110,113,0,0,0,0,0,0,112,115,0,0,0,0,0,0,0,0,0,0,0,0,0,0,0,0,0,0,0,0
0,111,114,0,111,114,0,0,0,0,0,0,0,0,0,0,112,115,0,0,111,114,0,0,0,0,0,0,0,0,0,0,0,0,0,0,0,0,0,0,0,0,0,0,0,0,0,0,0,0
0,112,115,0,112,115,110,113,0,110,113,0,0,0,0,0,0,0,0,182,112,115,0,0,0,0,0,0,0,0,0,0,0,0,0,0,0,0,0,0,0,0,0,0,0,0,0,0,0,0
0,0,0,182,0,0,111,114,0,111,114,0,0,110,113,0,0,0,0,0,0,0,0,0,0,0,0,0,0,0,0,0,0,0,0,0,0,0,0,0,0,0,0,118,118,118,118,118,118,118
0,0,0,0,0,0,112,115,0,112,115,182,0,111,114,0,0,0,0,0,0,0,0,0,0,0,0,118,118,118,118,118,118,118,118,118,118,118,118,118,118,118,118,120,120,120,120,120,120,120
0,0,0,0,0,0,0,0,0,0,110,113,0,112,115,0,0,0,0,0,0,0,0,0,0,118,118,120,120,120,120,120,120,120,120,120,120,120,120,120,120,120,120,120,120,120,120,120,120,120
0,0,0,0,0,0,0,0,0,0,111,114,0,0,0,110,113,0,0,0,0,0,0,0,118,120,120,120,120,120,120,120,120,120,120,120,120,120,120,120,120,120,120,120,120,120,120,120,120,120
0,0,0,0,0,0,0,182,0,0,112,115,0,0,182,111,114,0,0,0,0,0,0,118,120,120,120,120,120,120,120,120,120,120,120,120,120,120,120,120,120,120,120,120,120,120,120,120,120,120
0,0,0,0,0,0,0,0,0,0,0,0,0,110,113,112,115,0,0,0,0,0,118,120,120,120,120,120,120,120,120,120,120,120,120,120,120,120,120,120,120,120,120,120,120,120,120,120,120,120
0,0,0,0,0,0,0,0,0,0,0,0,0,111,114,0,0,0,0,0,0,0,120,120,120,120,120,120,120,120,120,120,120,120,120,120,120,120,120,120,120,120,120,120,120,120,120,120,120,120
0,0,0,0,0,0,182,0,0,0,0,0,0,112,115,0,0,0,0,0,0,0,120,120,120,120,120,120,120,120,120,120,120,120,119,119,119,119,119,119,120,120,120,120,120,120,120,120,120,120
0,0,0,289,291,0,0,0,0,0,0,0,0,0,0,0,0,0,0,0,0,0,120,120,120,120,120,120,120,120,120,120,120,119,0,0,0,0,0,0,119,119,119,120,120,120,120,120,120,120
0,0,0,290,292,0,0,0,0,0,0,0,0,0,0,182,0,0,0,0,0,0,120,120,120,120,120,120,120,120,120,120,119,0,0,0,0,0,0,0,0,0,0,119,120,120,120,120,120,120
0,0,0,0,0,0,0,0,0,0,0,0,0,0,0,0,0,0,0,0,0,0,119,120,120,120,120,120,120,120,120,119,0,0,0,0,0,0,0,0,0,0,0,0,119,120,120,120,120,120
0,0,0,0,0,0,0,0,0,0,0,0,0,0,0,0,0,0,0,0,0,0,0,119,119,119,119,119,119,119,119,0,0,0,0,0,0,0,0,0,0,0,0,0,0,119,120,120,120,120
0,0,0,0,0,0,0,0,0,0,0,0,0,0,0,0,0,0,0,0,0,0,0,0,0,0,0,0,0,0,0,0,0,0,0,0,0,0,0,0,0,0,0,0,0,0,119,120,120,120
0,0,0,0,0,0,0,0,0,0,0,0,0,0,0,0,0,182,0,0,0,0,0,0,0,0,0,0,0,0,0,0,0,0,0,0,0,0,0,0,0,0,0,0,0,0,0,120,120,120
0,182,0,0,0,0,0,0,0,0,0,0,0,0,0,0,0,0,0,0,0,0,0,118,118,118,118,118,118,118,118,0,0,0,0,0,0,0,0,0,0,0,0,0,0,0,0,120,120,120
0,0,0,0,0,0,0,0,0,0,0,0,0,182,0,0,0,0,0,0,0,0,118,120,120,120,120,120,120,120,120,118,0,0,0,0,0,0,0,0,0,0,0,0,0,0,0,120,120,120
0,0,0,0,0,0,0,0,0,0,0,0,0,0,0,0,0,0,0,0,0,0,120,120,120,120,120,120,120,120,120,120,118,118,118,0,0,0,0,0,0,0,0,0,0,0,118,120,120,120
0,0,0,0,0,0,0,0,0,0,0,0,0,0,0,0,0,0,0,0,0,0,120,120,120,120,120,120,120,120,120,120,120,120,120,118,118,118,118,118,0,0,0,0,0,118,120,120,120,120
0,0,0,0,0,0,0,0,0,0,0,0,0,0,0,182,0,0,0,0,0,0,120,120,120,120,120,120,120,120,120,120,120,120,120,120,120,120,120,120,118,118,118,118,118,120,120,120,120,120
0,182,0,0,0,0,0,0,0,182,0,0,0,0,0,0,0,0,0,0,0,0,120,120,120,120,120,120,120,120,120,120,120,120,120,120,120,120,120,120,120,120,120,120,120,120,120,120,120,120
0,0,0,0,0,0,0,0,0,0,0,0,0,0,0,0,0,0,0,0,0,0,120,120,120,120,120,120,120,120,120,120,120,120,120,120,120,120,120,120,120,120,120,120,120,120,120,120,120,120
0,0,0,0,0,0,0,0,0,0,0,0,0,0,0,0,0,0,0,0,0,0,120,120,120,120,120,120,120,120,120,120,120,120,120,120,120,120,120,120,120,120,120,120,120,120,120,120,120,120
296,296,296,296,296,296,296,296,296,296,299,0,0,0,0,0,0,0,0,0,0,0,119,120,120,120,120,120,120,120,120,120,120,120,120,120,120,120,120,120,120,120,120,120,120,120,120,120,120,120
0,0,0,0,0,0,0,0,0,0,306,296,296,299,0,0,0,0,0,0,0,0,0,120,120,120,120,120,120,120,120,120,120,120,120,120,120,120,120,120,120,120,120,120,120,120,120,120,120,120
0,0,0,0,0,0,0,0,0,0,0,0,0,306,296,299,0,0,0,0,0,0,0,120,120,120,120,119,119,119,119,119,119,119,119,119,119,119,119,120,120,120,120,120,120,120,120,120,120,120
0,0,0,0,0,0,0,0,0,0,0,0,0,0,0,306,298,299,0,0,0,0,0,120,120,119,119,0,0,0,0,0,0,0,0,0,0,0,0,119,119,119,120,120,120,120,120,120,120,120
0,0,0,0,0,0,0,0,0,0,0,0,0,0,0,0,0,300,0,0,0,307,298,119,119,0,0,0,0,0,0,0,0,0,0,0,0,0,0,0,0,0,119,119,119,120,120,120,120,120
0,83,86,0,83,86,0,0,0,0,0,0,0,0,0,0,0,300,0,0,0,300,0,0,0,0,0,0,0,0,0,0,0,0,0,0,0,0,0,0,0,0,0,0,0,119,120,120,120,120
0,84,87,0,84,87,0,0,0,0,0,0,0,0,0,0,0,300,0,0,0,300,0,0,0,0,0,0,0,0,0,0,0,0,0,0,0,0,0,0,0,0,0,0,0,0,119,119,120,120
0,85,88,0,85,88,0,0,0,0,0,0,0,0,0,0,0,300,0,0,0,300,0,0,0,0,0,0,0,0,0,0,0,0,0,0,0,0,0,0,0,0,0,0,0,0,0,0,119,120
0,0,0,0,0,289,291,0,0,0,0,0,0,0,0,0,0,306,0,0,0,306,0,0,0,0,0,0,0,0,0,0,0,0,0,0,0,0,0,0,0,0,0,0,0,0,0,0,0,119
0,0,0,0,0,290,292,0,0,0,0,0,0,0,83,86,0,0,0,0,0,0,0,0,0,0,0,0,0,0,0,0,0,0,0,0,0,0,0,0,0,0,0,0,0,0,0,0,0,0
0,0,0,0,0,0,0,0,0,0,0,0,0,0,84,87,0,0,0,0,0,0,0,0,0,0,0,0,0,0,0,0,0,0,0,0,0,0,0,0,0,0,0,0,0,0,0,0,0,0
0,0,0,0,0,0,0,0,0,0,0,0,0,0,85,88,0,0,0,0,0,0,0,0,0,0,0,0,0,0,0,0,0,0,0,0,0,0,0,0,0,0,0,0,0,0,0,0,0,0
0,0,204,0,0,0,0,0,0,0,0,0,0,0,0,0,0,0,0,0,0,0,0,0,0,0,0,0,0,0,0,0,0,0,0,0,0,0,0,0,0,0,0,0,0,0,0,0,0,0
83,86,0,0,83,86,0,0,0,0,0,0,0,0,0,0,0,0,0,0,0,0,0,0,0,0,0,0,0,0,0,0,0,0,0,0,0,0,0,0,0,0,0,0,0,0,0,0,0,0
84,87,0,0,84,87,0,0,0,83,86,0,0,0,0,0,0,0,0,0,0,0,0,0,0,0,0,0,0,0,0,0,0,0,0,0,0,0,0,0,0,0,0,0,0,0,0,0,0,0
85,88,0,0,85,88,0,0,0,84,87,209,0,0,204,0,0,0,0,0,0,0,0,0,0,0,0,0,0,0,0,0,0,0,0,0,0,0,0,0,0,0,0,0,0,0,0,0,0,0
0,0,0,0,0,0,0,0,0,85,88,0,0,0,0,0,0,0,0,0,0,0,0,0,0,0,0,0,0,0,0,0,0,0,0,0,0,0,0,0,0,0,0,0,0,0,0,0,0,0
0,83,86,0,0,0,0,0,0,0,0,0,0,0,0,0,204,0,0,0,0,0,0,0,0,0,0,0,0,0,0,0,0,0,0,0,0,0,0,0,0,0,0,0,0,0,0,0,0,0
0,84,87,0,0,0,0,0,0,0,0,0,0,83,86,0,0,0,0,0,0,0,0,0,0,0,0,0,0,0,0,0,0,0,0,0,0,0,0,0,0,0,0,0,0,0,0,0,0,0
0,85,88,0,0,0,0,0,0,0,0,0,0,84,87,0,0,0,0,0,0,0,0,0,0,0,0,0,0,0,0,0,0,0,0,0,0,0,0,0,0,0,0,0,0,0,0,0,0,0
0,0,0,0,0,83,86,0,0,0,83,86,0,85,88,0,0,0,0,0,0,0,0,0,0,0,0,0,0,0,0,0,0,0,0,0,0,0,0,0,0,0,0,0,0,0,0,0,0,0
0,0,0,0,0,84,87,0,0,0,84,87,0,0,0,0,0,0,0,0,0,0,0,0,0,0,0,0,0,0,0,0,0,0,0,0,0,0,0,0,0,0,0,0,0,0,0,0,0,0
0,0,0,0,0,85,88,0,0,0,85,88,0,0,0,0,0,0,0,0,0,0,0,0,0,0,0,0,0,0,0,0,0,0,0,0,0,0,0,0,0,0,0,0,0,0,0,0,0,0
0,83,86,0,0,0,0,0,0,0,0,0,0,0,0,0,0,204,0,0,0,0,0,0,0,0,0,0,0,0,0,0,0,0,0,0,0,0,0,0,0,0,0,0,0,0,0,0,0,0
0,84,87,0,0,0,0,0,0,0,0,83,86,0,0,0,0,0,0,0,0,0,0,0,0,0,0,0,0,0,0,0,401,404,0,0,0,0,0,0,0,0,0,0,0,0,0,0,0,0
0,85,88,0,0,0,0,0,0,0,0,84,87,0,0,0,0,0,0,0,0,0,0,0,0,0,0,0,0,0,0,0,402,405,0,0,0,0,0,0,0,0,0,0,0,0,0,0,0,0
0,0,0,0,0,0,0,83,86,0,0,85,88,0,0,0,0,0,0,0,0,0,0,0,0,0,0,0,0,0,0,0,403,406,0,0,0,0,0,0,0,0,0,0,0,0,0,0,0,0
0,0,0,0,0,0,0,84,87,0,0,0,0,0,0,0,0,0,0,0,0,0,0,0,0,0,0,0,0,0,0,0,0,0,0,0,0,0,0,0,0,0,0,0,0,0,0,0,0,261
0,0,83,86,0,0,0,85,88,0,0,0,0,0,0,0,0,0,0,0,0,0,0,0,0,0,0,0,0,0,0,0,0,0,0,0,0,0,0,0,0,0,0,0,261,0,159,159,159,159
0,0,84,87,0,0,204,0,0,0,0,289,291,0,0,0,0,0,0,0,0,0,0,0,0,0,0,0,0,0,0,0,0,0,0,0,0,261,0,0,0,0,0,159,159,159,161,161,161,161
0,0,85,88,0,0,0,0,0,0,0,290,292,0,0,0,0,0,0,0,0,0,0,0,0,0,0,0,0,261,0,0,0,0,0,0,159,159,159,159,159,159,159,161,161,161,161,161,161,161
0,83,86,0,0,0,83,86,0,0,0,0,0,0,0,0,0,0,0,0,0,0,0,0,0,0,0,0,0,0,0,0,0,261,0,159,161,161,161,161,161,161,161,161,161,161,161,161,161,161
0,84,87,0,209,0,84,87,0,0,0,0,0,0,389,391,393,0,0,0,0,0,0,0,0,0,0,0,0,0,0,261,159,159,159,161,161,161,161,161,161,161,161,161,161,161,161,161,161,161
0,85,88,0,0,0,85,88,0,0,209,0,0,0,390,392,394,0,0,0,0,0,0,0,0,0,0,0,0,0,159,159,161,161,161,161,161,161,161,161,161,161,161,161,161,161,161,161,161,161
0,0,0,83,86,0,0,0,83,86,0,0,0,0,83,86,0,0,0,0,0,0,0,0,0,0,0,0,0,0,161,161,161,161,161,161,161,161,161,161,161,161,161,161,161,161,161,161,161,161
0,0,0,84,87,0,0,0,84,87,0,0,0,0,84,87,0,0,0,0,0,0,0,0,0,0,0,0,0,159,161,161,161,161,161,161,161,161,161,161,161,161,161,161,161,161,161,161,161,161
0,0,0,85,88,0,0,0,85,88,0,0,0,0,85,88,0,0,209,0,0,0,0,0,0,0,0,0,261,161,161,161,161,161,161,161,161,161,161,161,161,161,161,161,161,161,161,161,161,161
0,0,0,0,0,0,0,0,0,0,0,0,0,0,0,0,0,0,209,0,0,0,0,0,0,0,0,0,0,161,161,161,161,161,161,161,161,161,161,161,161,161,161,161,161,161,161,161,161,161
[METADATA]
