35,35,35,35,35,35,35,35,35,35
35,35,37,37,37,37,37,37,35,35
35,35,37,35,35,35,35,37,35,35
35,35,37,35,35,35,35,37,35,35
35,35,37,35,35,35,35,37,35,35
35,35,37,37,37,37,37,37,35,35
35,35,35,35,37,37,35,35,35,35
0,0,0,0,0,0,0,0,0,0
[METADATA]
