0,0,0,0,0,0,0,0,0,46
0,0,0,0,0,0,0,0,0,45
0,0,0,41,42,39,40,0,0,0
0,0,0,0,0,0,0,0,0,0
0,0,0,0,0,0,0,0,0,0
46,0,0,0,0,0,0,0,0,46
45,0,0,10,0,0,10,0,0,45
0,0,0,0,0,0,0,0,0,0
[METADATA]
