40,41,41,41,40,41,40,41,40,0,0,0,0,0,0
42,43,43,43,42,43,42,43,42,40,41,40,41,40,41
0,0,0,0,0,0,0,0,0,42,43,42,43,42,43
0,0,0,0,0,0,0,0,0,0,0,0,0,0,0
0,0,0,0,0,0,0,0,0,0,0,0,0,0,0
0,0,0,0,0,0,0,0,0,0,0,0,0,0,0
0,0,0,0,0,0,0,0,0,0,0,0,0,0,0
0,0,0,0,0,0,0,0,0,0,0,0,0,0,0
0,0,0,0,0,0,0,0,0,40,41,41,41,40,41
40,44,40,41,40,41,41,41,40,42,43,43,43,42,43
[METADATA]
